HRRNum,HRR City,Last Update,Beds Avail,Vent. Avail,Staff Avail,Beds Needed,Vents Needed,Staff Needed,Beds Count,Vent. Count,Staff Count,Cases
1,AL- BIRMINGHAM,03-30-2020,8368,4207,NA,77,15,NA,8445,4222,NA,1210
2,AL- DOTHAN,03-30-2020,1240,647,NA,88,17,NA,1328,664,NA,1210
5,AL- HUNTSVILLE,03-30-2020,1770,907,NA,110,33,NA,1880,940,NA,484
6,AL- MOBILE,03-30-2020,2747,1395,NA,110,33,NA,2857,1428,NA,726
7,AL- MONTGOMERY,03-30-2020,1469,766,NA,77,7,NA,1546,773,NA,968
9,AL- TUSCALOOSA,03-30-2020,932,480,NA,66,19,NA,998,499,NA,484
11,AZ- MESA,03-30-2020,1958,988,NA,22,2,NA,1980,990,NA,1089
12,AZ- PHOENIX,03-30-2020,7498,3772,NA,77,15,NA,7575,3787,NA,605
14,AZ- SUN CITY,03-30-2020,766,401,NA,44,4,NA,810,405,NA,242
15,AZ- TUCSON,03-30-2020,2447,1255,NA,77,7,NA,2524,1262,NA,363
16,AR- FORT SMITH,03-30-2020,1171,607,NA,110,33,NA,1281,640,NA,484
18,AR- JONESBORO,03-30-2020,860,444,NA,44,8,NA,904,452,NA,968
19,AR- LITTLE ROCK,03-30-2020,5673,2877,NA,99,9,NA,5772,2886,NA,726
21,AR- SPRINGDALE,03-30-2020,1013,515,NA,44,13,NA,1057,528,NA,121
22,AR- TEXARKANA,03-30-2020,936,486,NA,44,4,NA,980,490,NA,121
23,CA- ORANGE CO.,03-30-2020,7541,3792,NA,110,33,NA,7651,3825,NA,968
25,CA- BAKERSFIELD,03-30-2020,3594,1802,NA,22,6,NA,3616,1808,NA,484
31,CA- CHICO,03-30-2020,629,318,NA,11,2,NA,640,320,NA,726
33,CA- CONTRA COSTA CO.,03-30-2020,1981,999,NA,22,2,NA,2003,1001,NA,121
43,CA- FRESNO,03-30-2020,2250,1135,NA,33,6,NA,2283,1141,NA,1089
56,CA- LOS ANGELES,03-30-2020,24726,12394,NA,77,7,NA,24803,12401,NA,726
58,CA- MODESTO,03-30-2020,1664,848,NA,55,11,NA,1719,859,NA,847
62,CA- NAPA,03-30-2020,527,286,NA,55,5,NA,582,291,NA,242
65,CA- ALAMEDA CO.,03-30-2020,3324,1678,NA,55,11,NA,3379,1689,NA,121
69,CA- PALM SPR/RANCHO MIR.,03-30-2020,943,504,NA,110,22,NA,1053,526,NA,847
73,CA- REDDING,03-30-2020,1071,540,NA,11,1,NA,1082,541,NA,121
77,CA- SACRAMENTO,03-30-2020,4696,2375,NA,88,17,NA,4784,2392,NA,121
78,CA- SALINAS,03-30-2020,727,383,NA,66,13,NA,793,396,NA,484
79,CA- SAN BERNARDINO,03-30-2020,5727,2880,NA,55,11,NA,5782,2891,NA,968
80,CA- SAN DIEGO,03-30-2020,6956,3501,NA,77,15,NA,7033,3516,NA,242
81,CA- SAN FRANCISCO,03-30-2020,4974,2517,NA,99,19,NA,5073,2536,NA,968
82,CA- SAN JOSE,03-30-2020,2971,1497,NA,55,16,NA,3026,1513,NA,847
83,CA- SAN LUIS OBISPO,03-30-2020,379,205,NA,77,23,NA,456,228,NA,484
85,CA- SAN MATEO CO.,03-30-2020,2652,1340,NA,44,8,NA,2696,1348,NA,242
86,CA- SANTA BARBARA,03-30-2020,955,481,NA,11,2,NA,966,483,NA,726
87,CA- SANTA CRUZ,03-30-2020,271,162,NA,88,17,NA,359,179,NA,726
89,CA- SANTA ROSA,03-30-2020,1817,922,NA,44,8,NA,1861,930,NA,847
91,CA- STOCKTON,03-30-2020,1019,523,NA,44,8,NA,1063,531,NA,1210
96,CA- VENTURA,03-30-2020,1518,775,NA,55,11,NA,1573,786,NA,484
101,CO- BOULDER,03-30-2020,431,224,NA,44,13,NA,475,237,NA,726
102,CO- COLORADO SPRINGS,03-30-2020,969,511,NA,66,6,NA,1035,517,NA,847
103,CO- DENVER,03-30-2020,4766,2387,NA,11,1,NA,4777,2388,NA,363
104,CO- FORT COLLINS,03-30-2020,584,314,NA,55,5,NA,639,319,NA,1210
105,CO- GRAND JUNCTION,03-30-2020,770,394,NA,22,2,NA,792,396,NA,121
106,CO- GREELEY,03-30-2020,678,369,NA,99,19,NA,777,388,NA,726
107,CO- PUEBLO,03-30-2020,710,391,NA,88,8,NA,798,399,NA,121
109,CT- BRIDGEPORT,03-30-2020,1662,838,NA,33,9,NA,1695,847,NA,363
110,CT- HARTFORD,03-30-2020,3201,1612,NA,55,16,NA,3256,1628,NA,484
111,CT- NEW HAVEN,03-30-2020,3742,1915,NA,110,11,NA,3852,1926,NA,242
112,DE- WILMINGTON,03-30-2020,1796,912,NA,66,19,NA,1862,931,NA,847
113,DC- WASHINGTON,03-30-2020,5467,2740,NA,22,4,NA,5489,2744,NA,968
115,FL- BRADENTON,03-30-2020,599,343,NA,110,11,NA,709,354,NA,605
116,FL- CLEARWATER,03-30-2020,1626,816,NA,11,2,NA,1637,818,NA,1089
118,FL- FORT LAUDERDALE,03-30-2020,8589,4316,NA,110,33,NA,8699,4349,NA,847
119,FL- FORT MYERS,03-30-2020,3782,1909,NA,44,4,NA,3826,1913,NA,363
120,FL- GAINESVILLE,03-30-2020,1819,914,NA,22,6,NA,1841,920,NA,1089
122,FL- HUDSON,03-30-2020,1153,597,NA,99,29,NA,1252,626,NA,242
123,FL- JACKSONVILLE,03-30-2020,4857,2451,NA,55,5,NA,4912,2456,NA,484
124,FL- LAKELAND,03-30-2020,980,526,NA,88,8,NA,1068,534,NA,968
127,FL- MIAMI,03-30-2020,10716,5385,NA,66,6,NA,10782,5391,NA,484
129,FL- OCALA,03-30-2020,1258,662,NA,110,22,NA,1368,684,NA,847
130,FL- ORLANDO,03-30-2020,10295,5167,NA,66,13,NA,10361,5180,NA,605
131,FL- ORMOND BEACH,03-30-2020,1544,794,NA,110,33,NA,1654,827,NA,121
133,FL- PANAMA CITY,03-30-2020,609,327,NA,55,5,NA,664,332,NA,847
134,FL- PENSACOLA,03-30-2020,2294,1163,NA,55,11,NA,2349,1174,NA,484
137,FL- SARASOTA,03-30-2020,1357,696,NA,88,26,NA,1445,722,NA,726
139,FL- ST PETERSBURG,03-30-2020,1587,796,NA,11,3,NA,1598,799,NA,726
140,FL- TALLAHASSEE,03-30-2020,2664,1339,NA,33,9,NA,2697,1348,NA,968
141,FL- TAMPA,03-30-2020,4183,2107,NA,77,23,NA,4260,2130,NA,726
142,GA- ALBANY,03-30-2020,964,522,NA,99,9,NA,1063,531,NA,484
144,GA- ATLANTA,03-30-2020,11869,5967,NA,110,22,NA,11979,5989,NA,726
145,GA- AUGUSTA,03-30-2020,2411,1214,NA,44,13,NA,2455,1227,NA,363
146,GA- COLUMBUS,03-30-2020,1204,613,NA,55,16,NA,1259,629,NA,605
147,GA- MACON,03-30-2020,2192,1105,NA,44,13,NA,2236,1118,NA,121
148,GA- ROME,03-30-2020,699,357,NA,33,9,NA,732,366,NA,363
149,GA- SAVANNAH,03-30-2020,2025,1026,NA,33,3,NA,2058,1029,NA,484
151,ID- BOISE,03-30-2020,2022,1033,NA,55,5,NA,2077,1038,NA,484
152,ID- IDAHO FALLS,03-30-2020,384,215,NA,77,15,NA,461,230,NA,968
154,IL- AURORA,03-30-2020,439,255,NA,88,8,NA,527,263,NA,484
155,IL- BLUE ISLAND,03-30-2020,2503,1262,NA,33,6,NA,2536,1268,NA,484
156,IL- CHICAGO,03-30-2020,8538,4278,NA,22,2,NA,8560,4280,NA,968
158,IL- ELGIN,03-30-2020,976,521,NA,110,22,NA,1086,543,NA,968
161,IL- EVANSTON,03-30-2020,2350,1195,NA,66,13,NA,2416,1208,NA,242
163,IL- HINSDALE,03-30-2020,1012,524,NA,88,26,NA,1100,550,NA,1089
164,IL- JOLIET,03-30-2020,1238,655,NA,88,8,NA,1326,663,NA,847
166,IL- MELROSE PARK,03-30-2020,3072,1541,NA,22,6,NA,3094,1547,NA,726
170,IL- PEORIA,03-30-2020,1793,916,NA,66,13,NA,1859,929,NA,1089
171,IL- ROCKFORD,03-30-2020,1487,757,NA,44,8,NA,1531,765,NA,847
172,IL- SPRINGFIELD,03-30-2020,2490,1256,NA,55,16,NA,2545,1272,NA,605
173,IL- URBANA,03-30-2020,995,506,NA,44,13,NA,1039,519,NA,605
175,IL- BLOOMINGTON,03-30-2020,179,125,NA,88,8,NA,267,133,NA,847
179,IN- EVANSVILLE,03-30-2020,1968,1007,NA,77,15,NA,2045,1022,NA,363
180,IN- FORT WAYNE,03-30-2020,2190,1100,NA,22,6,NA,2212,1106,NA,605
181,IN- GARY,03-30-2020,1429,746,NA,77,7,NA,1506,753,NA,968
183,IN- INDIANAPOLIS,03-30-2020,6340,3185,NA,77,23,NA,6417,3208,NA,121
184,IN- LAFAYETTE,03-30-2020,653,362,NA,88,8,NA,741,370,NA,1089
185,IN- MUNCIE,03-30-2020,331,183,NA,88,26,NA,419,209,NA,1089
186,IN- MUNSTER,03-30-2020,1143,574,NA,11,3,NA,1154,577,NA,605
187,IN- SOUTH BEND,03-30-2020,1518,761,NA,11,3,NA,1529,764,NA,1210
188,IN- TERRE HAUTE,03-30-2020,506,263,NA,33,6,NA,539,269,NA,968
190,IA- CEDAR RAPIDS,03-30-2020,1050,552,NA,66,6,NA,1116,558,NA,1210
191,IA- DAVENPORT,03-30-2020,2157,1098,NA,66,13,NA,2223,1111,NA,847
192,IA- DES MOINES,03-30-2020,3194,1637,NA,99,9,NA,3293,1646,NA,605
193,IA- DUBUQUE,03-30-2020,479,266,NA,66,6,NA,545,272,NA,605
194,IA- IOWA CITY,03-30-2020,1932,968,NA,11,3,NA,1943,971,NA,121
195,IA- MASON CITY,03-30-2020,689,362,NA,44,4,NA,733,366,NA,242
196,IA- SIOUX CITY,03-30-2020,1022,533,NA,110,33,NA,1132,566,NA,968
197,IA- WATERLOO,03-30-2020,628,318,NA,11,1,NA,639,319,NA,1089
200,KS- TOPEKA,03-30-2020,1536,770,NA,11,3,NA,1547,773,NA,605
201,KS- WICHITA,03-30-2020,4840,2464,NA,110,11,NA,4950,2475,NA,968
203,KY- COVINGTON,03-30-2020,1035,544,NA,66,6,NA,1101,550,NA,847
204,KY- LEXINGTON,03-30-2020,5140,2597,NA,66,6,NA,5206,2603,NA,121
205,KY- LOUISVILLE,03-30-2020,4761,2403,NA,55,5,NA,4816,2408,NA,1089
207,KY- OWENSBORO,03-30-2020,406,230,NA,66,6,NA,472,236,NA,726
208,KY- PADUCAH,03-30-2020,1534,794,NA,88,17,NA,1622,811,NA,121
209,LA- ALEXANDRIA,03-30-2020,936,490,NA,55,5,NA,991,495,NA,968
210,LA- BATON ROUGE,03-30-2020,2381,1211,NA,99,29,NA,2480,1240,NA,968
212,LA- HOUMA,03-30-2020,624,343,NA,77,7,NA,701,350,NA,847
213,LA- LAFAYETTE,03-30-2020,2074,1064,NA,88,17,NA,2162,1081,NA,363
214,LA- LAKE CHARLES,03-30-2020,832,423,NA,33,9,NA,865,432,NA,363
216,LA- METAIRIE,03-30-2020,912,476,NA,99,29,NA,1011,505,NA,121
217,LA- MONROE,03-30-2020,892,459,NA,33,3,NA,925,462,NA,605
218,LA- NEW ORLEANS,03-30-2020,2392,1209,NA,33,3,NA,2425,1212,NA,1089
219,LA- SHREVEPORT,03-30-2020,2692,1364,NA,44,4,NA,2736,1368,NA,1089
220,LA- SLIDELL,03-30-2020,416,235,NA,88,17,NA,504,252,NA,605
221,ME- BANGOR,03-30-2020,1068,543,NA,22,2,NA,1090,545,NA,242
222,ME- PORTLAND,03-30-2020,2559,1299,NA,66,13,NA,2625,1312,NA,968
223,MD- BALTIMORE,03-30-2020,6646,3343,NA,99,29,NA,6745,3372,NA,242
225,MD- SALISBURY,03-30-2020,926,467,NA,11,1,NA,937,468,NA,484
226,MD- TAKOMA PARK,03-30-2020,1243,639,NA,44,4,NA,1287,643,NA,242
227,MA- BOSTON,03-30-2020,10885,5463,NA,99,29,NA,10984,5492,NA,363
230,MA- SPRINGFIELD,03-30-2020,1557,792,NA,44,8,NA,1601,800,NA,363
231,MA- WORCESTER,03-30-2020,1532,810,NA,110,11,NA,1642,821,NA,121
232,MI- ANN ARBOR,03-30-2020,3242,1628,NA,22,4,NA,3264,1632,NA,484
233,MI- DEARBORN,03-30-2020,1578,809,NA,66,13,NA,1644,822,NA,968
234,MI- DETROIT,03-30-2020,4615,2321,NA,44,8,NA,4659,2329,NA,242
235,MI- FLINT,03-30-2020,1271,652,NA,55,11,NA,1326,663,NA,605
236,MI- GRAND RAPIDS,03-30-2020,2221,1128,NA,88,26,NA,2309,1154,NA,121
238,MI- KALAMAZOO,03-30-2020,1411,719,NA,66,19,NA,1477,738,NA,484
239,MI- LANSING,03-30-2020,1436,748,NA,99,19,NA,1535,767,NA,1089
240,MI- MARQUETTE,03-30-2020,433,228,NA,55,16,NA,488,244,NA,1089
242,MI- MUSKEGON,03-30-2020,459,261,NA,77,7,NA,536,268,NA,726
243,MI- PETOSKEY,03-30-2020,247,154,NA,99,19,NA,346,173,NA,121
244,MI- PONTIAC,03-30-2020,1173,590,NA,11,2,NA,1184,592,NA,1089
245,MI- ROYAL OAK,03-30-2020,2543,1292,NA,99,29,NA,2642,1321,NA,1210
246,MI- SAGINAW,03-30-2020,2041,1037,NA,55,11,NA,2096,1048,NA,726
248,MI- ST JOSEPH,03-30-2020,269,145,NA,33,6,NA,302,151,NA,484
249,MI- TRAVERSE CITY,03-30-2020,465,250,NA,44,4,NA,509,254,NA,847
250,MN- DULUTH,03-30-2020,1074,573,NA,88,8,NA,1162,581,NA,726
251,MN- MINNEAPOLIS,03-30-2020,8471,4249,NA,44,8,NA,8515,4257,NA,605
253,MN- ROCHESTER,03-30-2020,2489,1266,NA,110,33,NA,2599,1299,NA,968
254,MN- ST CLOUD,03-30-2020,652,337,NA,55,16,NA,707,353,NA,968
256,MN- ST PAUL,03-30-2020,2197,1116,NA,88,26,NA,2285,1142,NA,121
257,MS- GULFPORT,03-30-2020,729,382,NA,44,4,NA,773,386,NA,121
258,MS- HATTIESBURG,03-30-2020,1188,601,NA,22,4,NA,1210,605,NA,1089
259,MS- JACKSON,03-30-2020,4393,2214,NA,88,26,NA,4481,2240,NA,605
260,MS- MERIDIAN,03-30-2020,890,463,NA,88,26,NA,978,489,NA,484
261,MS- OXFORD,03-30-2020,594,306,NA,44,13,NA,638,319,NA,242
262,MS- TUPELO,03-30-2020,1542,789,NA,88,26,NA,1630,815,NA,726
263,MO- CAPE GIRARDEAU,03-30-2020,1005,509,NA,22,4,NA,1027,513,NA,968
264,MO- COLUMBIA,03-30-2020,1734,900,NA,110,22,NA,1844,922,NA,726
267,MO- JOPLIN,03-30-2020,943,476,NA,11,1,NA,954,477,NA,242
268,MO- KANSAS CITY,03-30-2020,7914,3961,NA,11,1,NA,7925,3962,NA,484
270,MO- SPRINGFIELD,03-30-2020,1904,968,NA,55,11,NA,1959,979,NA,968
273,MO- ST LOUIS,03-30-2020,12102,6081,NA,99,19,NA,12201,6100,NA,484
274,MT- BILLINGS,03-30-2020,2165,1100,NA,44,4,NA,2209,1104,NA,363
275,MT- GREAT FALLS,03-30-2020,761,394,NA,44,8,NA,805,402,NA,121
276,MT- MISSOULA,03-30-2020,1060,570,NA,99,9,NA,1159,579,NA,121
277,NE- LINCOLN,03-30-2020,1815,916,NA,22,2,NA,1837,918,NA,1210
278,NE- OMAHA,03-30-2020,5390,2726,NA,77,7,NA,5467,2733,NA,1210
279,NV- LAS VEGAS,03-30-2020,4005,2026,NA,77,15,NA,4082,2041,NA,484
280,NV- RENO,03-30-2020,1910,958,NA,11,2,NA,1921,960,NA,726
281,NH- LEBANON,03-30-2020,927,472,NA,44,13,NA,971,485,NA,726
282,NH- MANCHESTER,03-30-2020,1908,968,NA,66,19,NA,1974,987,NA,968
283,NJ- CAMDEN,03-30-2020,7932,3988,NA,55,5,NA,7987,3993,NA,605
284,NJ- HACKENSACK,03-30-2020,3718,1862,NA,11,2,NA,3729,1864,NA,363
285,NJ- MORRISTOWN,03-30-2020,1862,945,NA,66,19,NA,1928,964,NA,847
288,NJ- NEW BRUNSWICK,03-30-2020,2755,1382,NA,11,1,NA,2766,1383,NA,484
289,NJ- NEWARK,03-30-2020,4751,2397,NA,110,33,NA,4861,2430,NA,363
291,NJ- PATERSON,03-30-2020,1156,587,NA,22,2,NA,1178,589,NA,1089
292,NJ- RIDGEWOOD,03-30-2020,682,363,NA,110,33,NA,792,396,NA,363
293,NM- ALBUQUERQUE,03-30-2020,3337,1675,NA,22,4,NA,3359,1679,NA,847
295,NY- ALBANY,03-30-2020,4885,2460,NA,44,4,NA,4929,2464,NA,726
296,NY- BINGHAMTON,03-30-2020,874,459,NA,55,5,NA,929,464,NA,242
297,NY- BRONX,03-30-2020,3598,1806,NA,22,4,NA,3620,1810,NA,726
299,NY- BUFFALO,03-30-2020,3529,1784,NA,66,13,NA,3595,1797,NA,847
300,NY- ELMIRA,03-30-2020,1033,534,NA,44,4,NA,1077,538,NA,605
301,NY- EAST LONG ISLAND,03-30-2020,10895,5461,NA,44,8,NA,10939,5469,NA,968
304,NY- ROCHESTER,03-30-2020,2872,1463,NA,88,17,NA,2960,1480,NA,484
307,NY- SYRACUSE,03-30-2020,2803,1406,NA,22,6,NA,2825,1412,NA,484
308,NY- WHITE PLAINS,03-30-2020,2936,1478,NA,33,6,NA,2969,1484,NA,605
309,NC- ASHEVILLE,03-30-2020,1768,928,NA,110,11,NA,1878,939,NA,726
311,NC- CHARLOTTE,03-30-2020,5748,2892,NA,44,4,NA,5792,2896,NA,484
312,NC- DURHAM,03-30-2020,4540,2293,NA,77,15,NA,4617,2308,NA,1210
313,NC- GREENSBORO,03-30-2020,1695,878,NA,99,19,NA,1794,897,NA,968
314,NC- GREENVILLE,03-30-2020,2432,1247,NA,77,7,NA,2509,1254,NA,968
315,NC- HICKORY,03-30-2020,693,358,NA,55,16,NA,748,374,NA,242
318,NC- RALEIGH,03-30-2020,4213,2111,NA,22,6,NA,4235,2117,NA,242
319,NC- WILMINGTON,03-30-2020,1195,602,NA,22,6,NA,1217,608,NA,484
320,NC- WINSTON-SALEM,03-30-2020,3594,1833,NA,88,8,NA,3682,1841,NA,121
321,ND- BISMARCK,03-30-2020,750,402,NA,88,17,NA,838,419,NA,726
322,ND- FARGO MOORHEAD -MN,03-30-2020,2007,1008,NA,22,6,NA,2029,1014,NA,121
323,ND- GRAND FORKS,03-30-2020,499,276,NA,88,17,NA,587,293,NA,363
324,ND- MINOT,03-30-2020,667,341,NA,33,9,NA,700,350,NA,484
325,OH- AKRON,03-30-2020,2349,1206,NA,77,7,NA,2426,1213,NA,1210
326,OH- CANTON,03-30-2020,2038,1050,NA,77,7,NA,2115,1057,NA,484
327,OH- CINCINNATI,03-30-2020,4783,2394,NA,11,3,NA,4794,2397,NA,121
328,OH- CLEVELAND,03-30-2020,8727,4384,NA,99,29,NA,8826,4413,NA,363
329,OH- COLUMBUS,03-30-2020,8878,4470,NA,77,7,NA,8955,4477,NA,121
330,OH- DAYTON,03-30-2020,3191,1611,NA,77,23,NA,3268,1634,NA,726
331,OH- ELYRIA,03-30-2020,681,358,NA,44,4,NA,725,362,NA,484
332,OH- KETTERING,03-30-2020,1134,576,NA,22,2,NA,1156,578,NA,363
334,OH- TOLEDO,03-30-2020,4112,2087,NA,77,7,NA,4189,2094,NA,726
335,OH- YOUNGSTOWN,03-30-2020,2490,1267,NA,110,33,NA,2600,1300,NA,242
336,OK- LAWTON,03-30-2020,625,348,NA,88,8,NA,713,356,NA,363
339,OK- OKLAHOMA CITY,03-30-2020,6492,3264,NA,88,26,NA,6580,3290,NA,847
340,OK- TULSA,03-30-2020,4978,2498,NA,44,13,NA,5022,2511,NA,242
341,OR- BEND,03-30-2020,317,176,NA,88,26,NA,405,202,NA,484
342,OR- EUGENE,03-30-2020,1098,572,NA,77,15,NA,1175,587,NA,484
343,OR- MEDFORD,03-30-2020,932,476,NA,33,6,NA,965,482,NA,121
344,OR- PORTLAND,03-30-2020,5137,2609,NA,99,9,NA,5236,2618,NA,242
345,OR- SALEM,03-30-2020,425,216,NA,11,2,NA,436,218,NA,1089
346,PA- ALLENTOWN,03-30-2020,3113,1570,NA,44,8,NA,3157,1578,NA,121
347,PA- ALTOONA,03-30-2020,629,341,NA,66,6,NA,695,347,NA,1089
350,PA- DANVILLE,03-30-2020,1442,744,NA,77,15,NA,1519,759,NA,847
351,PA- ERIE,03-30-2020,2127,1094,NA,99,19,NA,2226,1113,NA,847
352,PA- HARRISBURG,03-30-2020,2203,1119,NA,88,26,NA,2291,1145,NA,726
354,PA- JOHNSTOWN,03-30-2020,630,359,NA,110,11,NA,740,370,NA,605
355,PA- LANCASTER,03-30-2020,1114,580,NA,77,15,NA,1191,595,NA,484
356,PA- PHILADELPHIA,03-30-2020,12443,6226,NA,11,1,NA,12454,6227,NA,1089
357,PA- PITTSBURGH,03-30-2020,11562,5803,NA,110,33,NA,11672,5836,NA,847
358,PA- READING,03-30-2020,1402,706,NA,22,6,NA,1424,712,NA,968
359,PA- SAYRE,03-30-2020,427,231,NA,44,4,NA,471,235,NA,1210
360,PA- SCRANTON,03-30-2020,794,433,NA,88,8,NA,882,441,NA,1089
362,PA- WILKES-BARRE,03-30-2020,611,319,NA,44,8,NA,655,327,NA,363
363,PA- YORK,03-30-2020,721,393,NA,110,22,NA,831,415,NA,363
364,RI- PROVIDENCE,03-30-2020,3066,1560,NA,66,6,NA,3132,1566,NA,1210
365,SC- CHARLESTON,03-30-2020,2878,1479,NA,99,9,NA,2977,1488,NA,968
366,SC- COLUMBIA,03-30-2020,3704,1870,NA,44,4,NA,3748,1874,NA,242
367,SC- FLORENCE,03-30-2020,1253,644,NA,88,26,NA,1341,670,NA,242
368,SC- GREENVILLE,03-30-2020,2381,1195,NA,11,1,NA,2392,1196,NA,242
369,SC- SPARTANBURG,03-30-2020,962,511,NA,99,19,NA,1061,530,NA,121
370,SD- RAPID CITY,03-30-2020,589,335,NA,99,9,NA,688,344,NA,1210
371,SD- SIOUX FALLS,03-30-2020,2730,1383,NA,44,4,NA,2774,1387,NA,968
373,TN- CHATTANOOGA,03-30-2020,2131,1109,NA,110,11,NA,2241,1120,NA,363
374,TN- JACKSON,03-30-2020,1295,664,NA,55,11,NA,1350,675,NA,242
375,TN- JOHNSON CITY,03-30-2020,863,455,NA,77,15,NA,940,470,NA,726
376,TN- KINGSPORT,03-30-2020,1909,978,NA,77,15,NA,1986,993,NA,968
377,TN- KNOXVILLE,03-30-2020,4120,2076,NA,55,11,NA,4175,2087,NA,726
379,TN- MEMPHIS,03-30-2020,6252,3153,NA,66,6,NA,6318,3159,NA,968
380,TN- NASHVILLE,03-30-2020,8477,4262,NA,77,15,NA,8554,4277,NA,1210
382,TX- ABILENE,03-30-2020,1284,660,NA,44,4,NA,1328,664,NA,484
383,TX- AMARILLO,03-30-2020,1480,749,NA,22,2,NA,1502,751,NA,605
385,TX- AUSTIN,03-30-2020,3432,1743,NA,66,6,NA,3498,1749,NA,121
386,TX- BEAUMONT,03-30-2020,1359,682,NA,11,3,NA,1370,685,NA,605
388,TX- BRYAN,03-30-2020,535,291,NA,77,15,NA,612,306,NA,726
390,TX- CORPUS CHRISTI,03-30-2020,1997,1015,NA,55,11,NA,2052,1026,NA,484
391,TX- DALLAS,03-30-2020,12223,6118,NA,22,4,NA,12245,6122,NA,968
393,TX- EL PASO,03-30-2020,2712,1363,NA,33,9,NA,2745,1372,NA,847
394,TX- FORT WORTH,03-30-2020,4908,2474,NA,99,29,NA,5007,2503,NA,968
396,TX- HARLINGEN,03-30-2020,1330,701,NA,88,8,NA,1418,709,NA,242
397,TX- HOUSTON,03-30-2020,17044,8531,NA,22,2,NA,17066,8533,NA,242
399,TX- LONGVIEW,03-30-2020,675,341,NA,11,2,NA,686,343,NA,242
400,TX- LUBBOCK,03-30-2020,2357,1192,NA,33,3,NA,2390,1195,NA,847
402,TX- MCALLEN,03-30-2020,1553,787,NA,33,6,NA,1586,793,NA,121
406,TX- ODESSA,03-30-2020,1248,642,NA,44,4,NA,1292,646,NA,605
411,TX- SAN ANGELO,03-30-2020,654,334,NA,33,9,NA,687,343,NA,484
412,TX- SAN ANTONIO,03-30-2020,7192,3614,NA,44,4,NA,7236,3618,NA,847
413,TX- TEMPLE,03-30-2020,840,440,NA,99,29,NA,939,469,NA,726
416,TX- TYLER,03-30-2020,1505,783,NA,99,19,NA,1604,802,NA,484
417,TX- VICTORIA,03-30-2020,701,370,NA,66,13,NA,767,383,NA,726
418,TX- WACO,03-30-2020,531,285,NA,66,13,NA,597,298,NA,121
420,TX- WICHITA FALLS,03-30-2020,635,329,NA,55,16,NA,690,345,NA,847
421,UT- OGDEN,03-30-2020,708,359,NA,22,6,NA,730,365,NA,605
422,UT- PROVO,03-30-2020,803,422,NA,99,29,NA,902,451,NA,1210
423,UT- SALT LAKE CITY,03-30-2020,3873,1968,NA,77,7,NA,3950,1975,NA,726
424,VT- BURLINGTON,03-30-2020,1551,786,NA,33,6,NA,1584,792,NA,1210
426,VA- ARLINGTON,03-30-2020,2849,1442,NA,44,4,NA,2893,1446,NA,968
427,VA- CHARLOTTESVILLE,03-30-2020,1337,682,NA,66,19,NA,1403,701,NA,363
428,VA- LYNCHBURG,03-30-2020,697,371,NA,55,5,NA,752,376,NA,484
429,VA- NEWPORT NEWS,03-30-2020,1062,554,NA,77,15,NA,1139,569,NA,484
430,VA- NORFOLK,03-30-2020,2663,1345,NA,44,8,NA,2707,1353,NA,242
431,VA- RICHMOND,03-30-2020,4623,2327,NA,77,23,NA,4700,2350,NA,605
432,VA- ROANOKE,03-30-2020,2783,1394,NA,11,3,NA,2794,1397,NA,726
435,VA- WINCHESTER,03-30-2020,878,455,NA,55,11,NA,933,466,NA,484
437,WA- EVERETT,03-30-2020,799,404,NA,22,6,NA,821,410,NA,726
438,WA- OLYMPIA,03-30-2020,642,328,NA,33,9,NA,675,337,NA,726
439,WA- SEATTLE,03-30-2020,5377,2702,NA,66,19,NA,5443,2721,NA,726
440,WA- SPOKANE,03-30-2020,3715,1875,NA,44,4,NA,3759,1879,NA,1089
441,WA- TACOMA,03-30-2020,1183,609,NA,44,4,NA,1227,613,NA,363
442,WA- YAKIMA,03-30-2020,491,281,NA,88,8,NA,579,289,NA,121
443,WV- CHARLESTON,03-30-2020,2326,1193,NA,99,19,NA,2425,1212,NA,1089
444,WV- HUNTINGTON,03-30-2020,1617,819,NA,33,6,NA,1650,825,NA,847
445,WV- MORGANTOWN,03-30-2020,1664,862,NA,99,19,NA,1763,881,NA,605
446,WI- APPLETON,03-30-2020,551,289,NA,66,19,NA,617,308,NA,242
447,WI- GREEN BAY,03-30-2020,1590,799,NA,11,1,NA,1601,800,NA,1210
448,WI- LA CROSSE,03-30-2020,856,448,NA,99,29,NA,955,477,NA,363
449,WI- MADISON,03-30-2020,2998,1501,NA,11,3,NA,3009,1504,NA,121
450,WI- MARSHFIELD,03-30-2020,1112,583,NA,66,6,NA,1178,589,NA,1089
451,WI- MILWAUKEE,03-30-2020,8206,4112,NA,44,13,NA,8250,4125,NA,968
303,NY- NEW YORK,03-30-2020,15458,7765,NA,88,8,NA,15546,7773,NA,363
452,WI- NEENAH,03-30-2020,448,268,NA,110,11,NA,558,279,NA,968
456,WI- WAUSAU,03-30-2020,499,269,NA,66,13,NA,565,282,NA,121
457,WY- CASPER,03-30-2020,657,342,NA,44,8,NA,701,350,NA,484
