HRRNum,HRR City,Last Update,Beds Avail,Vent. Avail,Staff Avail,Beds Needed,Vents Needed,Staff Needed,Beds Count,Vent. Count,Staff Count,Cases
1,AL- BIRMINGHAM,04-16-2020,8220,4177,NA,225,45,NA,8445,4222,NA,6075
2,AL- DOTHAN,04-16-2020,1013,601,NA,315,63,NA,1328,664,NA,10125
5,AL- HUNTSVILLE,04-16-2020,1520,832,NA,360,108,NA,1880,940,NA,16200
6,AL- MOBILE,04-16-2020,2812,1419,NA,45,9,NA,2857,1428,NA,4050
7,AL- MONTGOMERY,04-16-2020,1366,719,NA,180,54,NA,1546,773,NA,16200
9,AL- TUSCALOOSA,04-16-2020,728,445,NA,270,54,NA,998,499,NA,8100
11,AZ- MESA,04-16-2020,1620,882,NA,360,108,NA,1980,990,NA,4050
12,AZ- PHOENIX,04-16-2020,7350,3720,NA,225,67,NA,7575,3787,NA,10125
14,AZ- SUN CITY,04-16-2020,540,351,NA,270,54,NA,810,405,NA,6075
15,AZ- TUCSON,04-16-2020,2209,1231,NA,315,31,NA,2524,1262,NA,8100
16,AR- FORT SMITH,04-16-2020,1101,622,NA,180,18,NA,1281,640,NA,8100
18,AR- JONESBORO,04-16-2020,634,398,NA,270,54,NA,904,452,NA,2025
19,AR- LITTLE ROCK,04-16-2020,5592,2868,NA,180,18,NA,5772,2886,NA,6075
21,AR- SPRINGDALE,04-16-2020,967,519,NA,90,9,NA,1057,528,NA,14175
22,AR- TEXARKANA,04-16-2020,620,454,NA,360,36,NA,980,490,NA,6075
23,CA- ORANGE CO.,04-16-2020,7246,3785,NA,405,40,NA,7651,3825,NA,6075
25,CA- BAKERSFIELD,04-16-2020,3301,1714,NA,315,94,NA,3616,1808,NA,16200
31,CA- CHICO,04-16-2020,280,284,NA,360,36,NA,640,320,NA,12150
33,CA- CONTRA COSTA CO.,04-16-2020,1733,974,NA,270,27,NA,2003,1001,NA,16200
43,CA- FRESNO,04-16-2020,2148,1128,NA,135,13,NA,2283,1141,NA,20250
56,CA- LOS ANGELES,04-16-2020,24533,12320,NA,270,81,NA,24803,12401,NA,16200
58,CA- MODESTO,04-16-2020,1404,796,NA,315,63,NA,1719,859,NA,2025
62,CA- NAPA,04-16-2020,357,269,NA,225,22,NA,582,291,NA,16200
65,CA- ALAMEDA CO.,04-16-2020,3334,1676,NA,45,13,NA,3379,1689,NA,4050
69,CA- PALM SPR/RANCHO MIR.,04-16-2020,693,418,NA,360,108,NA,1053,526,NA,6075
73,CA- REDDING,04-16-2020,992,514,NA,90,27,NA,1082,541,NA,14175
77,CA- SACRAMENTO,04-16-2020,4739,2383,NA,45,9,NA,4784,2392,NA,6075
78,CA- SALINAS,04-16-2020,388,315,NA,405,81,NA,793,396,NA,12150
79,CA- SAN BERNARDINO,04-16-2020,5737,2882,NA,45,9,NA,5782,2891,NA,6075
80,CA- SAN DIEGO,04-16-2020,6628,3476,NA,405,40,NA,7033,3516,NA,20250
81,CA- SAN FRANCISCO,04-16-2020,4848,2491,NA,225,45,NA,5073,2536,NA,14175
82,CA- SAN JOSE,04-16-2020,2621,1392,NA,405,121,NA,3026,1513,NA,8100
83,CA- SAN LUIS OBISPO,04-16-2020,276,210,NA,180,18,NA,456,228,NA,14175
85,CA- SAN MATEO CO.,04-16-2020,2516,1330,NA,180,18,NA,2696,1348,NA,20250
86,CA- SANTA BARBARA,04-16-2020,606,375,NA,360,108,NA,966,483,NA,4050
87,CA- SANTA CRUZ,04-16-2020,89,98,NA,270,81,NA,359,179,NA,18225
89,CA- SANTA ROSA,04-16-2020,1636,908,NA,225,22,NA,1861,930,NA,18225
91,CA- STOCKTON,04-16-2020,613,396,NA,450,135,NA,1063,531,NA,20250
96,CA- VENTURA,04-16-2020,1528,782,NA,45,4,NA,1573,786,NA,10125
101,CO- BOULDER,04-16-2020,295,201,NA,180,36,NA,475,237,NA,10125
102,CO- COLORADO SPRINGS,04-16-2020,630,436,NA,405,81,NA,1035,517,NA,12150
103,CO- DENVER,04-16-2020,4372,2267,NA,405,121,NA,4777,2388,NA,8100
104,CO- FORT COLLINS,04-16-2020,279,247,NA,360,72,NA,639,319,NA,6075
105,CO- GRAND JUNCTION,04-16-2020,747,387,NA,45,9,NA,792,396,NA,12150
106,CO- GREELEY,04-16-2020,597,370,NA,180,18,NA,777,388,NA,6075
107,CO- PUEBLO,04-16-2020,663,386,NA,135,13,NA,798,399,NA,2025
109,CT- BRIDGEPORT,04-16-2020,1605,829,NA,90,18,NA,1695,847,NA,18225
110,CT- HARTFORD,04-16-2020,3031,1606,NA,225,22,NA,3256,1628,NA,2025
111,CT- NEW HAVEN,04-16-2020,3762,1917,NA,90,9,NA,3852,1926,NA,18225
112,DE- WILMINGTON,04-16-2020,1547,868,NA,315,63,NA,1862,931,NA,10125
113,DC- WASHINGTON,04-16-2020,5039,2699,NA,450,45,NA,5489,2744,NA,2025
115,FL- BRADENTON,04-16-2020,259,264,NA,450,90,NA,709,354,NA,18225
116,FL- CLEARWATER,04-16-2020,1592,814,NA,45,4,NA,1637,818,NA,10125
118,FL- FORT LAUDERDALE,04-16-2020,8429,4268,NA,270,81,NA,8699,4349,NA,18225
119,FL- FORT MYERS,04-16-2020,3691,1873,NA,135,40,NA,3826,1913,NA,20250
120,FL- GAINESVILLE,04-16-2020,1391,875,NA,450,45,NA,1841,920,NA,2025
122,FL- HUDSON,04-16-2020,802,581,NA,450,45,NA,1252,626,NA,8100
123,FL- JACKSONVILLE,04-16-2020,4507,2375,NA,405,81,NA,4912,2456,NA,2025
124,FL- LAKELAND,04-16-2020,663,494,NA,405,40,NA,1068,534,NA,20250
127,FL- MIAMI,04-16-2020,10737,5378,NA,45,13,NA,10782,5391,NA,4050
129,FL- OCALA,04-16-2020,1323,680,NA,45,4,NA,1368,684,NA,14175
130,FL- ORLANDO,04-16-2020,10181,5126,NA,180,54,NA,10361,5180,NA,14175
131,FL- ORMOND BEACH,04-16-2020,1249,706,NA,405,121,NA,1654,827,NA,12150
133,FL- PANAMA CITY,04-16-2020,394,278,NA,270,54,NA,664,332,NA,20250
134,FL- PENSACOLA,04-16-2020,2259,1147,NA,90,27,NA,2349,1174,NA,8100
137,FL- SARASOTA,04-16-2020,995,677,NA,450,45,NA,1445,722,NA,18225
139,FL- ST PETERSBURG,04-16-2020,1508,781,NA,90,18,NA,1598,799,NA,6075
140,FL- TALLAHASSEE,04-16-2020,2427,1321,NA,270,27,NA,2697,1348,NA,6075
141,FL- TAMPA,04-16-2020,3990,2103,NA,270,27,NA,4260,2130,NA,12150
142,GA- ALBANY,04-16-2020,928,504,NA,135,27,NA,1063,531,NA,8100
144,GA- ATLANTA,04-16-2020,11664,5926,NA,315,63,NA,11979,5989,NA,18225
145,GA- AUGUSTA,04-16-2020,2095,1191,NA,360,36,NA,2455,1227,NA,2025
146,GA- COLUMBUS,04-16-2020,1079,593,NA,180,36,NA,1259,629,NA,14175
147,GA- MACON,04-16-2020,2146,1109,NA,90,9,NA,2236,1118,NA,18225
148,GA- ROME,04-16-2020,507,344,NA,225,22,NA,732,366,NA,18225
149,GA- SAVANNAH,04-16-2020,1788,948,NA,270,81,NA,2058,1029,NA,18225
151,ID- BOISE,04-16-2020,1987,1020,NA,90,18,NA,2077,1038,NA,8100
152,ID- IDAHO FALLS,04-16-2020,371,203,NA,90,27,NA,461,230,NA,12150
154,IL- AURORA,04-16-2020,167,191,NA,360,72,NA,527,263,NA,10125
155,IL- BLUE ISLAND,04-16-2020,2446,1259,NA,90,9,NA,2536,1268,NA,4050
156,IL- CHICAGO,04-16-2020,8155,4159,NA,405,121,NA,8560,4280,NA,6075
158,IL- ELGIN,04-16-2020,861,521,NA,225,22,NA,1086,543,NA,12150
161,IL- EVANSTON,04-16-2020,2146,1154,NA,270,54,NA,2416,1208,NA,4050
163,IL- HINSDALE,04-16-2020,875,483,NA,225,67,NA,1100,550,NA,18225
164,IL- JOLIET,04-16-2020,1101,618,NA,225,45,NA,1326,663,NA,18225
166,IL- MELROSE PARK,04-16-2020,2869,1480,NA,225,67,NA,3094,1547,NA,14175
170,IL- PEORIA,04-16-2020,1499,821,NA,360,108,NA,1859,929,NA,4050
171,IL- ROCKFORD,04-16-2020,1351,729,NA,180,36,NA,1531,765,NA,20250
172,IL- SPRINGFIELD,04-16-2020,2275,1218,NA,270,54,NA,2545,1272,NA,20250
173,IL- URBANA,04-16-2020,679,447,NA,360,72,NA,1039,519,NA,18225
175,IL- BLOOMINGTON,04-16-2020,0,12,NA,405,121,NA,267,133,NA,8100
179,IN- EVANSVILLE,04-16-2020,1775,968,NA,270,54,NA,2045,1022,NA,6075
180,IN- FORT WAYNE,04-16-2020,1987,1039,NA,225,67,NA,2212,1106,NA,20250
181,IN- GARY,04-16-2020,1056,663,NA,450,90,NA,1506,753,NA,12150
183,IN- INDIANAPOLIS,04-16-2020,5967,3163,NA,450,45,NA,6417,3208,NA,2025
184,IN- LAFAYETTE,04-16-2020,561,316,NA,180,54,NA,741,370,NA,12150
185,IN- MUNCIE,04-16-2020,329,191,NA,90,18,NA,419,209,NA,6075
186,IN- MUNSTER,04-16-2020,929,532,NA,225,45,NA,1154,577,NA,8100
187,IN- SOUTH BEND,04-16-2020,1124,683,NA,405,81,NA,1529,764,NA,6075
188,IN- TERRE HAUTE,04-16-2020,224,206,NA,315,63,NA,539,269,NA,12150
190,IA- CEDAR RAPIDS,04-16-2020,1071,549,NA,45,9,NA,1116,558,NA,18225
191,IA- DAVENPORT,04-16-2020,1953,1057,NA,270,54,NA,2223,1111,NA,14175
192,IA- DES MOINES,04-16-2020,3023,1619,NA,270,27,NA,3293,1646,NA,10125
193,IA- DUBUQUE,04-16-2020,500,259,NA,45,13,NA,545,272,NA,16200
194,IA- IOWA CITY,04-16-2020,1628,877,NA,315,94,NA,1943,971,NA,10125
195,IA- MASON CITY,04-16-2020,283,231,NA,450,135,NA,733,366,NA,14175
196,IA- SIOUX CITY,04-16-2020,727,485,NA,405,81,NA,1132,566,NA,20250
197,IA- WATERLOO,04-16-2020,279,247,NA,360,72,NA,639,319,NA,10125
200,KS- TOPEKA,04-16-2020,1322,751,NA,225,22,NA,1547,773,NA,18225
201,KS- WICHITA,04-16-2020,4905,2466,NA,45,9,NA,4950,2475,NA,2025
203,KY- COVINGTON,04-16-2020,831,523,NA,270,27,NA,1101,550,NA,18225
204,KY- LEXINGTON,04-16-2020,5161,2590,NA,45,13,NA,5206,2603,NA,14175
205,KY- LOUISVILLE,04-16-2020,4636,2390,NA,180,18,NA,4816,2408,NA,12150
207,KY- OWENSBORO,04-16-2020,157,173,NA,315,63,NA,472,236,NA,2025
208,KY- PADUCAH,04-16-2020,1172,766,NA,450,45,NA,1622,811,NA,16200
209,LA- ALEXANDRIA,04-16-2020,946,491,NA,45,4,NA,991,495,NA,20250
210,LA- BATON ROUGE,04-16-2020,2120,1132,NA,360,108,NA,2480,1240,NA,6075
212,LA- HOUMA,04-16-2020,251,260,NA,450,90,NA,701,350,NA,4050
213,LA- LAFAYETTE,04-16-2020,1802,1045,NA,360,36,NA,2162,1081,NA,8100
214,LA- LAKE CHARLES,04-16-2020,550,401,NA,315,31,NA,865,432,NA,8100
216,LA- METAIRIE,04-16-2020,606,384,NA,405,121,NA,1011,505,NA,2025
217,LA- MONROE,04-16-2020,565,390,NA,360,72,NA,925,462,NA,6075
218,LA- NEW ORLEANS,04-16-2020,2335,1194,NA,90,18,NA,2425,1212,NA,8100
219,LA- SHREVEPORT,04-16-2020,2511,1346,NA,225,22,NA,2736,1368,NA,4050
220,LA- SLIDELL,04-16-2020,279,230,NA,225,22,NA,504,252,NA,14175
221,ME- BANGOR,04-16-2020,730,473,NA,360,72,NA,1090,545,NA,10125
222,ME- PORTLAND,04-16-2020,2265,1204,NA,360,108,NA,2625,1312,NA,18225
223,MD- BALTIMORE,04-16-2020,6340,3291,NA,405,81,NA,6745,3372,NA,10125
225,MD- SALISBURY,04-16-2020,577,396,NA,360,72,NA,937,468,NA,14175
226,MD- TAKOMA PARK,04-16-2020,1242,630,NA,45,13,NA,1287,643,NA,14175
227,MA- BOSTON,04-16-2020,10894,5465,NA,90,27,NA,10984,5492,NA,16200
230,MA- SPRINGFIELD,04-16-2020,1196,760,NA,405,40,NA,1601,800,NA,4050
231,MA- WORCESTER,04-16-2020,1372,740,NA,270,81,NA,1642,821,NA,8100
232,MI- ANN ARBOR,04-16-2020,3084,1578,NA,180,54,NA,3264,1632,NA,6075
233,MI- DEARBORN,04-16-2020,1554,813,NA,90,9,NA,1644,822,NA,20250
234,MI- DETROIT,04-16-2020,4389,2302,NA,270,27,NA,4659,2329,NA,4050
235,MI- FLINT,04-16-2020,1281,654,NA,45,9,NA,1326,663,NA,10125
236,MI- GRAND RAPIDS,04-16-2020,1949,1082,NA,360,72,NA,2309,1154,NA,8100
238,MI- KALAMAZOO,04-16-2020,1342,711,NA,135,27,NA,1477,738,NA,12150
239,MI- LANSING,04-16-2020,1085,677,NA,450,90,NA,1535,767,NA,20250
240,MI- MARQUETTE,04-16-2020,308,226,NA,180,18,NA,488,244,NA,2025
242,MI- MUSKEGON,04-16-2020,131,147,NA,405,121,NA,536,268,NA,6075
243,MI- PETOSKEY,04-16-2020,0,83,NA,450,90,NA,346,173,NA,18225
244,MI- PONTIAC,04-16-2020,1094,565,NA,90,27,NA,1184,592,NA,2025
245,MI- ROYAL OAK,04-16-2020,2597,1308,NA,45,13,NA,2642,1321,NA,2025
246,MI- SAGINAW,04-16-2020,1736,976,NA,360,72,NA,2096,1048,NA,12150
248,MI- ST JOSEPH,04-16-2020,77,106,NA,225,45,NA,302,151,NA,16200
249,MI- TRAVERSE CITY,04-16-2020,329,236,NA,180,18,NA,509,254,NA,10125
250,MN- DULUTH,04-16-2020,1117,568,NA,45,13,NA,1162,581,NA,4050
251,MN- MINNEAPOLIS,04-16-2020,8380,4217,NA,135,40,NA,8515,4257,NA,18225
253,MN- ROCHESTER,04-16-2020,2374,1232,NA,225,67,NA,2599,1299,NA,12150
254,MN- ST CLOUD,04-16-2020,347,317,NA,360,36,NA,707,353,NA,12150
256,MN- ST PAUL,04-16-2020,1970,1048,NA,315,94,NA,2285,1142,NA,4050
257,MS- GULFPORT,04-16-2020,323,341,NA,450,45,NA,773,386,NA,14175
258,MS- HATTIESBURG,04-16-2020,1165,596,NA,45,9,NA,1210,605,NA,20250
259,MS- JACKSON,04-16-2020,4211,2159,NA,270,81,NA,4481,2240,NA,12150
260,MS- MERIDIAN,04-16-2020,618,453,NA,360,36,NA,978,489,NA,16200
261,MS- OXFORD,04-16-2020,503,306,NA,135,13,NA,638,319,NA,14175
262,MS- TUPELO,04-16-2020,1540,788,NA,90,27,NA,1630,815,NA,16200
263,MO- CAPE GIRARDEAU,04-16-2020,622,432,NA,405,81,NA,1027,513,NA,6075
264,MO- COLUMBIA,04-16-2020,1529,891,NA,315,31,NA,1844,922,NA,2025
267,MO- JOPLIN,04-16-2020,684,423,NA,270,54,NA,954,477,NA,8100
268,MO- KANSAS CITY,04-16-2020,7610,3868,NA,315,94,NA,7925,3962,NA,20250
270,MO- SPRINGFIELD,04-16-2020,1689,898,NA,270,81,NA,1959,979,NA,14175
273,MO- ST LOUIS,04-16-2020,12021,6082,NA,180,18,NA,12201,6100,NA,4050
274,MT- BILLINGS,04-16-2020,2119,1077,NA,90,27,NA,2209,1104,NA,12150
275,MT- GREAT FALLS,04-16-2020,445,366,NA,360,36,NA,805,402,NA,2025
276,MT- MISSOULA,04-16-2020,844,548,NA,315,31,NA,1159,579,NA,6075
277,NE- LINCOLN,04-16-2020,1522,855,NA,315,63,NA,1837,918,NA,8100
278,NE- OMAHA,04-16-2020,5152,2639,NA,315,94,NA,5467,2733,NA,4050
279,NV- LAS VEGAS,04-16-2020,3632,1906,NA,450,135,NA,4082,2041,NA,14175
280,NV- RENO,04-16-2020,1741,906,NA,180,54,NA,1921,960,NA,4050
281,NH- LEBANON,04-16-2020,521,440,NA,450,45,NA,971,485,NA,14175
282,NH- MANCHESTER,04-16-2020,1569,947,NA,405,40,NA,1974,987,NA,6075
283,NJ- CAMDEN,04-16-2020,7762,3971,NA,225,22,NA,7987,3993,NA,2025
284,NJ- HACKENSACK,04-16-2020,3504,1842,NA,225,22,NA,3729,1864,NA,2025
285,NJ- MORRISTOWN,04-16-2020,1793,924,NA,135,40,NA,1928,964,NA,18225
288,NJ- NEW BRUNSWICK,04-16-2020,2496,1329,NA,270,54,NA,2766,1383,NA,18225
289,NJ- NEWARK,04-16-2020,4546,2399,NA,315,31,NA,4861,2430,NA,14175
291,NJ- PATERSON,04-16-2020,863,558,NA,315,31,NA,1178,589,NA,16200
292,NJ- RIDGEWOOD,04-16-2020,342,306,NA,450,90,NA,792,396,NA,18225
293,NM- ALBUQUERQUE,04-16-2020,3089,1598,NA,270,81,NA,3359,1679,NA,4050
295,NY- ALBANY,04-16-2020,4524,2424,NA,405,40,NA,4929,2464,NA,10125
296,NY- BINGHAMTON,04-16-2020,839,455,NA,90,9,NA,929,464,NA,2025
297,NY- BRONX,04-16-2020,3170,1675,NA,450,135,NA,3620,1810,NA,6075
299,NY- BUFFALO,04-16-2020,3280,1766,NA,315,31,NA,3595,1797,NA,18225
300,NY- ELMIRA,04-16-2020,987,520,NA,90,18,NA,1077,538,NA,2025
301,NY- EAST LONG ISLAND,04-16-2020,10714,5424,NA,225,45,NA,10939,5469,NA,14175
304,NY- ROCHESTER,04-16-2020,2510,1390,NA,450,90,NA,2960,1480,NA,8100
307,NY- SYRACUSE,04-16-2020,2735,1385,NA,90,27,NA,2825,1412,NA,2025
308,NY- WHITE PLAINS,04-16-2020,2834,1457,NA,135,27,NA,2969,1484,NA,20250
309,NC- ASHEVILLE,04-16-2020,1428,849,NA,450,90,NA,1878,939,NA,12150
311,NC- CHARLOTTE,04-16-2020,5702,2878,NA,90,18,NA,5792,2896,NA,4050
312,NC- DURHAM,04-16-2020,4527,2290,NA,90,18,NA,4617,2308,NA,14175
313,NC- GREENSBORO,04-16-2020,1614,861,NA,180,36,NA,1794,897,NA,6075
314,NC- GREENVILLE,04-16-2020,2104,1133,NA,405,121,NA,2509,1254,NA,14175
315,NC- HICKORY,04-16-2020,388,302,NA,360,72,NA,748,374,NA,16200
318,NC- RALEIGH,04-16-2020,4055,2081,NA,180,36,NA,4235,2117,NA,12150
319,NC- WILMINGTON,04-16-2020,1037,554,NA,180,54,NA,1217,608,NA,20250
320,NC- WINSTON-SALEM,04-16-2020,3547,1814,NA,135,27,NA,3682,1841,NA,6075
321,ND- BISMARCK,04-16-2020,478,311,NA,360,108,NA,838,419,NA,20250
322,ND- FARGO MOORHEAD -MN,04-16-2020,1894,987,NA,135,27,NA,2029,1014,NA,8100
323,ND- GRAND FORKS,04-16-2020,182,212,NA,405,81,NA,587,293,NA,16200
324,ND- MINOT,04-16-2020,340,314,NA,360,36,NA,700,350,NA,20250
325,OH- AKRON,04-16-2020,2291,1173,NA,135,40,NA,2426,1213,NA,4050
326,OH- CANTON,04-16-2020,2070,1044,NA,45,13,NA,2115,1057,NA,6075
327,OH- CINCINNATI,04-16-2020,4749,2388,NA,45,9,NA,4794,2397,NA,20250
328,OH- CLEVELAND,04-16-2020,8601,4391,NA,225,22,NA,8826,4413,NA,8100
329,OH- COLUMBUS,04-16-2020,8820,4437,NA,135,40,NA,8955,4477,NA,8100
330,OH- DAYTON,04-16-2020,3223,1621,NA,45,13,NA,3268,1634,NA,12150
331,OH- ELYRIA,04-16-2020,410,299,NA,315,63,NA,725,362,NA,16200
332,OH- KETTERING,04-16-2020,751,457,NA,405,121,NA,1156,578,NA,2025
334,OH- TOLEDO,04-16-2020,4144,2081,NA,45,13,NA,4189,2094,NA,6075
335,OH- YOUNGSTOWN,04-16-2020,2555,1296,NA,45,4,NA,2600,1300,NA,2025
336,OK- LAWTON,04-16-2020,668,347,NA,45,9,NA,713,356,NA,14175
339,OK- OKLAHOMA CITY,04-16-2020,6130,3200,NA,450,90,NA,6580,3290,NA,20250
340,OK- TULSA,04-16-2020,4752,2430,NA,270,81,NA,5022,2511,NA,20250
341,OR- BEND,04-16-2020,360,189,NA,45,13,NA,405,202,NA,6075
342,OR- EUGENE,04-16-2020,905,533,NA,270,54,NA,1175,587,NA,2025
343,OR- MEDFORD,04-16-2020,740,460,NA,225,22,NA,965,482,NA,18225
344,OR- PORTLAND,04-16-2020,5146,2609,NA,90,9,NA,5236,2618,NA,8100
345,OR- SALEM,04-16-2020,166,191,NA,270,27,NA,436,218,NA,6075
346,PA- ALLENTOWN,04-16-2020,2797,1506,NA,360,72,NA,3157,1578,NA,14175
347,PA- ALTOONA,04-16-2020,290,266,NA,405,81,NA,695,347,NA,18225
350,PA- DANVILLE,04-16-2020,1114,638,NA,405,121,NA,1519,759,NA,4050
351,PA- ERIE,04-16-2020,1956,1059,NA,270,54,NA,2226,1113,NA,6075
352,PA- HARRISBURG,04-16-2020,2201,1127,NA,90,18,NA,2291,1145,NA,16200
354,PA- JOHNSTOWN,04-16-2020,290,325,NA,450,45,NA,740,370,NA,12150
355,PA- LANCASTER,04-16-2020,1056,568,NA,135,27,NA,1191,595,NA,6075
356,PA- PHILADELPHIA,04-16-2020,12229,6182,NA,225,45,NA,12454,6227,NA,10125
357,PA- PITTSBURGH,04-16-2020,11582,5827,NA,90,9,NA,11672,5836,NA,18225
358,PA- READING,04-16-2020,1154,685,NA,270,27,NA,1424,712,NA,18225
359,PA- SAYRE,04-16-2020,336,222,NA,135,13,NA,471,235,NA,10125
360,PA- SCRANTON,04-16-2020,657,374,NA,225,67,NA,882,441,NA,14175
362,PA- WILKES-BARRE,04-16-2020,205,282,NA,450,45,NA,655,327,NA,14175
363,PA- YORK,04-16-2020,426,375,NA,405,40,NA,831,415,NA,2025
364,RI- PROVIDENCE,04-16-2020,2862,1539,NA,270,27,NA,3132,1566,NA,20250
365,SC- CHARLESTON,04-16-2020,2662,1394,NA,315,94,NA,2977,1488,NA,14175
366,SC- COLUMBIA,04-16-2020,3433,1811,NA,315,63,NA,3748,1874,NA,14175
367,SC- FLORENCE,04-16-2020,936,549,NA,405,121,NA,1341,670,NA,4050
368,SC- GREENVILLE,04-16-2020,2032,1124,NA,360,72,NA,2392,1196,NA,2025
369,SC- SPARTANBURG,04-16-2020,791,449,NA,270,81,NA,1061,530,NA,4050
370,SD- RAPID CITY,04-16-2020,598,326,NA,90,18,NA,688,344,NA,10125
371,SD- SIOUX FALLS,04-16-2020,2549,1342,NA,225,45,NA,2774,1387,NA,12150
373,TN- CHATTANOOGA,04-16-2020,2061,1084,NA,180,36,NA,2241,1120,NA,4050
374,TN- JACKSON,04-16-2020,1215,635,NA,135,40,NA,1350,675,NA,18225
375,TN- JOHNSON CITY,04-16-2020,850,452,NA,90,18,NA,940,470,NA,4050
376,TN- KINGSPORT,04-16-2020,1851,953,NA,135,40,NA,1986,993,NA,16200
377,TN- KNOXVILLE,04-16-2020,3770,2047,NA,405,40,NA,4175,2087,NA,10125
379,TN- MEMPHIS,04-16-2020,6138,3105,NA,180,54,NA,6318,3159,NA,12150
380,TN- NASHVILLE,04-16-2020,8464,4250,NA,90,27,NA,8554,4277,NA,10125
382,TX- ABILENE,04-16-2020,1283,651,NA,45,13,NA,1328,664,NA,14175
383,TX- AMARILLO,04-16-2020,1187,657,NA,315,94,NA,1502,751,NA,8100
385,TX- AUSTIN,04-16-2020,3363,1722,NA,135,27,NA,3498,1749,NA,8100
386,TX- BEAUMONT,04-16-2020,1280,667,NA,90,18,NA,1370,685,NA,4050
388,TX- BRYAN,04-16-2020,522,297,NA,90,9,NA,612,306,NA,4050
390,TX- CORPUS CHRISTI,04-16-2020,1917,999,NA,135,27,NA,2052,1026,NA,4050
391,TX- DALLAS,04-16-2020,11930,6028,NA,315,94,NA,12245,6122,NA,14175
393,TX- EL PASO,04-16-2020,2655,1354,NA,90,18,NA,2745,1372,NA,20250
394,TX- FORT WORTH,04-16-2020,4917,2494,NA,90,9,NA,5007,2503,NA,12150
396,TX- HARLINGEN,04-16-2020,1193,664,NA,225,45,NA,1418,709,NA,14175
397,TX- HOUSTON,04-16-2020,16661,8493,NA,405,40,NA,17066,8533,NA,18225
399,TX- LONGVIEW,04-16-2020,506,307,NA,180,36,NA,686,343,NA,16200
400,TX- LUBBOCK,04-16-2020,2120,1168,NA,270,27,NA,2390,1195,NA,8100
402,TX- MCALLEN,04-16-2020,1496,775,NA,90,18,NA,1586,793,NA,16200
406,TX- ODESSA,04-16-2020,1067,624,NA,225,22,NA,1292,646,NA,10125
411,TX- SAN ANGELO,04-16-2020,282,303,NA,405,40,NA,687,343,NA,20250
412,TX- SAN ANTONIO,04-16-2020,6876,3582,NA,360,36,NA,7236,3618,NA,20250
413,TX- TEMPLE,04-16-2020,714,447,NA,225,22,NA,939,469,NA,20250
416,TX- TYLER,04-16-2020,1244,766,NA,360,36,NA,1604,802,NA,8100
417,TX- VICTORIA,04-16-2020,677,374,NA,90,9,NA,767,383,NA,2025
418,TX- WACO,04-16-2020,462,285,NA,135,13,NA,597,298,NA,12150
420,TX- WICHITA FALLS,04-16-2020,330,273,NA,360,72,NA,690,345,NA,14175
421,UT- OGDEN,04-16-2020,685,356,NA,45,9,NA,730,365,NA,14175
422,UT- PROVO,04-16-2020,767,438,NA,135,13,NA,902,451,NA,14175
423,UT- SALT LAKE CITY,04-16-2020,3860,1957,NA,90,18,NA,3950,1975,NA,18225
424,VT- BURLINGTON,04-16-2020,1539,779,NA,45,13,NA,1584,792,NA,4050
426,VA- ARLINGTON,04-16-2020,2848,1437,NA,45,9,NA,2893,1446,NA,6075
427,VA- CHARLOTTESVILLE,04-16-2020,1043,593,NA,360,108,NA,1403,701,NA,16200
428,VA- LYNCHBURG,04-16-2020,482,349,NA,270,27,NA,752,376,NA,20250
429,VA- NEWPORT NEWS,04-16-2020,869,515,NA,270,54,NA,1139,569,NA,4050
430,VA- NORFOLK,04-16-2020,2347,1281,NA,360,72,NA,2707,1353,NA,6075
431,VA- RICHMOND,04-16-2020,4250,2260,NA,450,90,NA,4700,2350,NA,18225
432,VA- ROANOKE,04-16-2020,2434,1361,NA,360,36,NA,2794,1397,NA,2025
435,VA- WINCHESTER,04-16-2020,483,376,NA,450,90,NA,933,466,NA,14175
437,WA- EVERETT,04-16-2020,371,320,NA,450,90,NA,821,410,NA,12150
438,WA- OLYMPIA,04-16-2020,360,274,NA,315,63,NA,675,337,NA,20250
439,WA- SEATTLE,04-16-2020,5308,2708,NA,135,13,NA,5443,2721,NA,6075
440,WA- SPOKANE,04-16-2020,3489,1852,NA,270,27,NA,3759,1879,NA,20250
441,WA- TACOMA,04-16-2020,1047,595,NA,180,18,NA,1227,613,NA,20250
442,WA- YAKIMA,04-16-2020,219,253,NA,360,36,NA,579,289,NA,16200
443,WV- CHARLESTON,04-16-2020,1975,1122,NA,450,90,NA,2425,1212,NA,10125
444,WV- HUNTINGTON,04-16-2020,1515,798,NA,135,27,NA,1650,825,NA,4050
445,WV- MORGANTOWN,04-16-2020,1313,746,NA,450,135,NA,1763,881,NA,10125
446,WI- APPLETON,04-16-2020,527,281,NA,90,27,NA,617,308,NA,2025
447,WI- GREEN BAY,04-16-2020,1556,791,NA,45,9,NA,1601,800,NA,16200
448,WI- LA CROSSE,04-16-2020,685,450,NA,270,27,NA,955,477,NA,4050
449,WI- MADISON,04-16-2020,2739,1450,NA,270,54,NA,3009,1504,NA,6075
450,WI- MARSHFIELD,04-16-2020,1133,585,NA,45,4,NA,1178,589,NA,10125
451,WI- MILWAUKEE,04-16-2020,7845,4044,NA,405,81,NA,8250,4125,NA,4050
303,NY- NEW YORK,04-16-2020,15096,7728,NA,450,45,NA,15546,7773,NA,20250
452,WI- NEENAH,04-16-2020,153,198,NA,405,81,NA,558,279,NA,2025
456,WI- WAUSAU,04-16-2020,385,264,NA,180,18,NA,565,282,NA,2025
457,WY- CASPER,04-16-2020,386,287,NA,315,63,NA,701,350,NA,18225
