HRRNum,HRR City,Last Update,Beds Avail,Vent. Avail,Staff Avail,Beds Needed,Vents Needed,Staff Needed,Beds Count,Vent. Count,Staff Count,Cases
1,AL- BIRMINGHAM,04-11-2020,8235,4180,NA,210,42,NA,8445,4222,NA,12250
2,AL- DOTHAN,04-11-2020,1223,633,NA,105,31,NA,1328,664,NA,11025
5,AL- HUNTSVILLE,04-11-2020,1635,891,NA,245,49,NA,1880,940,NA,4900
6,AL- MOBILE,04-11-2020,2647,1407,NA,210,21,NA,2857,1428,NA,11025
7,AL- MONTGOMERY,04-11-2020,1266,689,NA,280,84,NA,1546,773,NA,3675
9,AL- TUSCALOOSA,04-11-2020,963,489,NA,35,10,NA,998,499,NA,8575
11,AZ- MESA,04-11-2020,1875,969,NA,105,21,NA,1980,990,NA,4900
12,AZ- PHOENIX,04-11-2020,7295,3703,NA,280,84,NA,7575,3787,NA,12250
14,AZ- SUN CITY,04-11-2020,635,353,NA,175,52,NA,810,405,NA,9800
15,AZ- TUCSON,04-11-2020,2384,1248,NA,140,14,NA,2524,1262,NA,4900
16,AR- FORT SMITH,04-11-2020,1246,630,NA,35,10,NA,1281,640,NA,3675
18,AR- JONESBORO,04-11-2020,589,389,NA,315,63,NA,904,452,NA,3675
19,AR- LITTLE ROCK,04-11-2020,5457,2855,NA,315,31,NA,5772,2886,NA,1225
21,AR- SPRINGDALE,04-11-2020,777,472,NA,280,56,NA,1057,528,NA,7350
22,AR- TEXARKANA,04-11-2020,735,417,NA,245,73,NA,980,490,NA,12250
23,CA- ORANGE CO.,04-11-2020,7301,3720,NA,350,105,NA,7651,3825,NA,7350
25,CA- BAKERSFIELD,04-11-2020,3406,1766,NA,210,42,NA,3616,1808,NA,6125
31,CA- CHICO,04-11-2020,325,257,NA,315,63,NA,640,320,NA,6125
33,CA- CONTRA COSTA CO.,04-11-2020,1968,998,NA,35,3,NA,2003,1001,NA,8575
43,CA- FRESNO,04-11-2020,2108,1089,NA,175,52,NA,2283,1141,NA,12250
56,CA- LOS ANGELES,04-11-2020,24453,12366,NA,350,35,NA,24803,12401,NA,3675
58,CA- MODESTO,04-11-2020,1684,856,NA,35,3,NA,1719,859,NA,3675
62,CA- NAPA,04-11-2020,407,274,NA,175,17,NA,582,291,NA,3675
65,CA- ALAMEDA CO.,04-11-2020,3274,1679,NA,105,10,NA,3379,1689,NA,2450
69,CA- PALM SPR/RANCHO MIR.,04-11-2020,948,495,NA,105,31,NA,1053,526,NA,2450
73,CA- REDDING,04-11-2020,977,531,NA,105,10,NA,1082,541,NA,12250
77,CA- SACRAMENTO,04-11-2020,4469,2298,NA,315,94,NA,4784,2392,NA,11025
78,CA- SALINAS,04-11-2020,618,344,NA,175,52,NA,793,396,NA,3675
79,CA- SAN BERNARDINO,04-11-2020,5537,2818,NA,245,73,NA,5782,2891,NA,12250
80,CA- SAN DIEGO,04-11-2020,6683,3446,NA,350,70,NA,7033,3516,NA,2450
81,CA- SAN FRANCISCO,04-11-2020,4968,2515,NA,105,21,NA,5073,2536,NA,6125
82,CA- SAN JOSE,04-11-2020,2956,1499,NA,70,14,NA,3026,1513,NA,3675
83,CA- SAN LUIS OBISPO,04-11-2020,421,218,NA,35,10,NA,456,228,NA,8575
85,CA- SAN MATEO CO.,04-11-2020,2626,1341,NA,70,7,NA,2696,1348,NA,2450
86,CA- SANTA BARBARA,04-11-2020,616,448,NA,350,35,NA,966,483,NA,9800
87,CA- SANTA CRUZ,04-11-2020,79,151,NA,280,28,NA,359,179,NA,12250
89,CA- SANTA ROSA,04-11-2020,1756,920,NA,105,10,NA,1861,930,NA,6125
91,CA- STOCKTON,04-11-2020,958,521,NA,105,10,NA,1063,531,NA,7350
96,CA- VENTURA,04-11-2020,1223,716,NA,350,70,NA,1573,786,NA,7350
101,CO- BOULDER,04-11-2020,265,216,NA,210,21,NA,475,237,NA,12250
102,CO- COLORADO SPRINGS,04-11-2020,930,507,NA,105,10,NA,1035,517,NA,6125
103,CO- DENVER,04-11-2020,4427,2318,NA,350,70,NA,4777,2388,NA,7350
104,CO- FORT COLLINS,04-11-2020,464,267,NA,175,52,NA,639,319,NA,2450
105,CO- GRAND JUNCTION,04-11-2020,547,372,NA,245,24,NA,792,396,NA,7350
106,CO- GREELEY,04-11-2020,462,325,NA,315,63,NA,777,388,NA,7350
107,CO- PUEBLO,04-11-2020,588,357,NA,210,42,NA,798,399,NA,12250
109,CT- BRIDGEPORT,04-11-2020,1485,784,NA,210,63,NA,1695,847,NA,3675
110,CT- HARTFORD,04-11-2020,3151,1607,NA,105,21,NA,3256,1628,NA,8575
111,CT- NEW HAVEN,04-11-2020,3607,1877,NA,245,49,NA,3852,1926,NA,2450
112,DE- WILMINGTON,04-11-2020,1652,910,NA,210,21,NA,1862,931,NA,6125
113,DC- WASHINGTON,04-11-2020,5314,2727,NA,175,17,NA,5489,2744,NA,7350
115,FL- BRADENTON,04-11-2020,359,284,NA,350,70,NA,709,354,NA,6125
116,FL- CLEARWATER,04-11-2020,1497,790,NA,140,28,NA,1637,818,NA,3675
118,FL- FORT LAUDERDALE,04-11-2020,8524,4314,NA,175,35,NA,8699,4349,NA,9800
119,FL- FORT MYERS,04-11-2020,3721,1892,NA,105,21,NA,3826,1913,NA,12250
120,FL- GAINESVILLE,04-11-2020,1736,899,NA,105,21,NA,1841,920,NA,4900
122,FL- HUDSON,04-11-2020,1147,605,NA,105,21,NA,1252,626,NA,6125
123,FL- JACKSONVILLE,04-11-2020,4562,2351,NA,350,105,NA,4912,2456,NA,6125
124,FL- LAKELAND,04-11-2020,893,517,NA,175,17,NA,1068,534,NA,12250
127,FL- MIAMI,04-11-2020,10432,5321,NA,350,70,NA,10782,5391,NA,7350
129,FL- OCALA,04-11-2020,1123,635,NA,245,49,NA,1368,684,NA,8575
130,FL- ORLANDO,04-11-2020,10081,5124,NA,280,56,NA,10361,5180,NA,4900
131,FL- ORMOND BEACH,04-11-2020,1514,799,NA,140,28,NA,1654,827,NA,8575
133,FL- PANAMA CITY,04-11-2020,419,308,NA,245,24,NA,664,332,NA,6125
134,FL- PENSACOLA,04-11-2020,2139,1111,NA,210,63,NA,2349,1174,NA,3675
137,FL- SARASOTA,04-11-2020,1270,705,NA,175,17,NA,1445,722,NA,12250
139,FL- ST PETERSBURG,04-11-2020,1283,705,NA,315,94,NA,1598,799,NA,9800
140,FL- TALLAHASSEE,04-11-2020,2522,1296,NA,175,52,NA,2697,1348,NA,9800
141,FL- TAMPA,04-11-2020,4050,2067,NA,210,63,NA,4260,2130,NA,9800
142,GA- ALBANY,04-11-2020,818,482,NA,245,49,NA,1063,531,NA,7350
144,GA- ATLANTA,04-11-2020,11874,5958,NA,105,31,NA,11979,5989,NA,11025
145,GA- AUGUSTA,04-11-2020,2245,1164,NA,210,63,NA,2455,1227,NA,9800
146,GA- COLUMBUS,04-11-2020,1189,615,NA,70,14,NA,1259,629,NA,9800
147,GA- MACON,04-11-2020,2061,1083,NA,175,35,NA,2236,1118,NA,4900
148,GA- ROME,04-11-2020,452,338,NA,280,28,NA,732,366,NA,8575
149,GA- SAVANNAH,04-11-2020,1743,935,NA,315,94,NA,2058,1029,NA,12250
151,ID- BOISE,04-11-2020,2042,1028,NA,35,10,NA,2077,1038,NA,9800
152,ID- IDAHO FALLS,04-11-2020,181,146,NA,280,84,NA,461,230,NA,9800
154,IL- AURORA,04-11-2020,457,249,NA,70,14,NA,527,263,NA,11025
155,IL- BLUE ISLAND,04-11-2020,2431,1237,NA,105,31,NA,2536,1268,NA,7350
156,IL- CHICAGO,04-11-2020,8490,4259,NA,70,21,NA,8560,4280,NA,6125
158,IL- ELGIN,04-11-2020,1016,536,NA,70,7,NA,1086,543,NA,1225
161,IL- EVANSTON,04-11-2020,2381,1201,NA,35,7,NA,2416,1208,NA,3675
163,IL- HINSDALE,04-11-2020,785,519,NA,315,31,NA,1100,550,NA,8575
164,IL- JOLIET,04-11-2020,1011,569,NA,315,94,NA,1326,663,NA,2450
166,IL- MELROSE PARK,04-11-2020,2884,1484,NA,210,63,NA,3094,1547,NA,6125
170,IL- PEORIA,04-11-2020,1614,856,NA,245,73,NA,1859,929,NA,7350
171,IL- ROCKFORD,04-11-2020,1286,716,NA,245,49,NA,1531,765,NA,1225
172,IL- SPRINGFIELD,04-11-2020,2370,1220,NA,175,52,NA,2545,1272,NA,7350
173,IL- URBANA,04-11-2020,689,414,NA,350,105,NA,1039,519,NA,11025
175,IL- BLOOMINGTON,04-11-2020,127,119,NA,140,14,NA,267,133,NA,11025
179,IN- EVANSVILLE,04-11-2020,1975,1015,NA,70,7,NA,2045,1022,NA,11025
180,IN- FORT WAYNE,04-11-2020,2107,1085,NA,105,21,NA,2212,1106,NA,6125
181,IN- GARY,04-11-2020,1471,743,NA,35,10,NA,1506,753,NA,1225
183,IN- INDIANAPOLIS,04-11-2020,6347,3187,NA,70,21,NA,6417,3208,NA,11025
184,IN- LAFAYETTE,04-11-2020,636,339,NA,105,31,NA,741,370,NA,12250
185,IN- MUNCIE,04-11-2020,209,188,NA,210,21,NA,419,209,NA,7350
186,IN- MUNSTER,04-11-2020,874,549,NA,280,28,NA,1154,577,NA,7350
187,IN- SOUTH BEND,04-11-2020,1424,733,NA,105,31,NA,1529,764,NA,8575
188,IN- TERRE HAUTE,04-11-2020,329,206,NA,210,63,NA,539,269,NA,6125
190,IA- CEDAR RAPIDS,04-11-2020,801,464,NA,315,94,NA,1116,558,NA,2450
191,IA- DAVENPORT,04-11-2020,1978,1087,NA,245,24,NA,2223,1111,NA,4900
192,IA- DES MOINES,04-11-2020,3258,1639,NA,35,7,NA,3293,1646,NA,2450
193,IA- DUBUQUE,04-11-2020,510,269,NA,35,3,NA,545,272,NA,9800
194,IA- IOWA CITY,04-11-2020,1663,915,NA,280,56,NA,1943,971,NA,11025
195,IA- MASON CITY,04-11-2020,698,356,NA,35,10,NA,733,366,NA,3675
196,IA- SIOUX CITY,04-11-2020,1027,556,NA,105,10,NA,1132,566,NA,2450
197,IA- WATERLOO,04-11-2020,604,312,NA,35,7,NA,639,319,NA,2450
200,KS- TOPEKA,04-11-2020,1267,717,NA,280,56,NA,1547,773,NA,2450
201,KS- WICHITA,04-11-2020,4775,2440,NA,175,35,NA,4950,2475,NA,12250
203,KY- COVINGTON,04-11-2020,1031,543,NA,70,7,NA,1101,550,NA,3675
204,KY- LEXINGTON,04-11-2020,5171,2596,NA,35,7,NA,5206,2603,NA,3675
205,KY- LOUISVILLE,04-11-2020,4571,2335,NA,245,73,NA,4816,2408,NA,3675
207,KY- OWENSBORO,04-11-2020,122,131,NA,350,105,NA,472,236,NA,8575
208,KY- PADUCAH,04-11-2020,1517,780,NA,105,31,NA,1622,811,NA,4900
209,LA- ALEXANDRIA,04-11-2020,956,492,NA,35,3,NA,991,495,NA,11025
210,LA- BATON ROUGE,04-11-2020,2270,1198,NA,210,42,NA,2480,1240,NA,3675
212,LA- HOUMA,04-11-2020,631,343,NA,70,7,NA,701,350,NA,8575
213,LA- LAFAYETTE,04-11-2020,1987,1029,NA,175,52,NA,2162,1081,NA,6125
214,LA- LAKE CHARLES,04-11-2020,620,359,NA,245,73,NA,865,432,NA,4900
216,LA- METAIRIE,04-11-2020,976,495,NA,35,10,NA,1011,505,NA,8575
217,LA- MONROE,04-11-2020,750,445,NA,175,17,NA,925,462,NA,8575
218,LA- NEW ORLEANS,04-11-2020,2390,1205,NA,35,7,NA,2425,1212,NA,1225
219,LA- SHREVEPORT,04-11-2020,2491,1344,NA,245,24,NA,2736,1368,NA,4900
220,LA- SLIDELL,04-11-2020,364,210,NA,140,42,NA,504,252,NA,6125
221,ME- BANGOR,04-11-2020,845,496,NA,245,49,NA,1090,545,NA,3675
222,ME- PORTLAND,04-11-2020,2590,1305,NA,35,7,NA,2625,1312,NA,11025
223,MD- BALTIMORE,04-11-2020,6570,3337,NA,175,35,NA,6745,3372,NA,3675
225,MD- SALISBURY,04-11-2020,797,426,NA,140,42,NA,937,468,NA,3675
226,MD- TAKOMA PARK,04-11-2020,1007,559,NA,280,84,NA,1287,643,NA,7350
227,MA- BOSTON,04-11-2020,10774,5471,NA,210,21,NA,10984,5492,NA,4900
230,MA- SPRINGFIELD,04-11-2020,1286,737,NA,315,63,NA,1601,800,NA,8575
231,MA- WORCESTER,04-11-2020,1502,807,NA,140,14,NA,1642,821,NA,2450
232,MI- ANN ARBOR,04-11-2020,3194,1625,NA,70,7,NA,3264,1632,NA,4900
233,MI- DEARBORN,04-11-2020,1364,738,NA,280,84,NA,1644,822,NA,6125
234,MI- DETROIT,04-11-2020,4414,2305,NA,245,24,NA,4659,2329,NA,8575
235,MI- FLINT,04-11-2020,1256,642,NA,70,21,NA,1326,663,NA,11025
236,MI- GRAND RAPIDS,04-11-2020,2064,1105,NA,245,49,NA,2309,1154,NA,8575
238,MI- KALAMAZOO,04-11-2020,1127,633,NA,350,105,NA,1477,738,NA,1225
239,MI- LANSING,04-11-2020,1360,732,NA,175,35,NA,1535,767,NA,4900
240,MI- MARQUETTE,04-11-2020,383,213,NA,105,31,NA,488,244,NA,11025
242,MI- MUSKEGON,04-11-2020,186,198,NA,350,70,NA,536,268,NA,11025
243,MI- PETOSKEY,04-11-2020,311,170,NA,35,3,NA,346,173,NA,3675
244,MI- PONTIAC,04-11-2020,939,568,NA,245,24,NA,1184,592,NA,12250
245,MI- ROYAL OAK,04-11-2020,2432,1300,NA,210,21,NA,2642,1321,NA,4900
246,MI- SAGINAW,04-11-2020,1921,996,NA,175,52,NA,2096,1048,NA,1225
248,MI- ST JOSEPH,04-11-2020,127,99,NA,175,52,NA,302,151,NA,3675
249,MI- TRAVERSE CITY,04-11-2020,299,191,NA,210,63,NA,509,254,NA,7350
250,MN- DULUTH,04-11-2020,917,508,NA,245,73,NA,1162,581,NA,8575
251,MN- MINNEAPOLIS,04-11-2020,8165,4222,NA,350,35,NA,8515,4257,NA,6125
253,MN- ROCHESTER,04-11-2020,2354,1226,NA,245,73,NA,2599,1299,NA,4900
254,MN- ST CLOUD,04-11-2020,462,329,NA,245,24,NA,707,353,NA,12250
256,MN- ST PAUL,04-11-2020,1970,1079,NA,315,63,NA,2285,1142,NA,8575
257,MS- GULFPORT,04-11-2020,563,323,NA,210,63,NA,773,386,NA,6125
258,MS- HATTIESBURG,04-11-2020,860,570,NA,350,35,NA,1210,605,NA,12250
259,MS- JACKSON,04-11-2020,4166,2146,NA,315,94,NA,4481,2240,NA,9800
260,MS- MERIDIAN,04-11-2020,943,482,NA,35,7,NA,978,489,NA,7350
261,MS- OXFORD,04-11-2020,533,309,NA,105,10,NA,638,319,NA,12250
262,MS- TUPELO,04-11-2020,1560,801,NA,70,14,NA,1630,815,NA,9800
263,MO- CAPE GIRARDEAU,04-11-2020,782,489,NA,245,24,NA,1027,513,NA,7350
264,MO- COLUMBIA,04-11-2020,1599,849,NA,245,73,NA,1844,922,NA,9800
267,MO- JOPLIN,04-11-2020,814,463,NA,140,14,NA,954,477,NA,12250
268,MO- KANSAS CITY,04-11-2020,7645,3934,NA,280,28,NA,7925,3962,NA,7350
270,MO- SPRINGFIELD,04-11-2020,1644,885,NA,315,94,NA,1959,979,NA,6125
273,MO- ST LOUIS,04-11-2020,12026,6048,NA,175,52,NA,12201,6100,NA,11025
274,MT- BILLINGS,04-11-2020,2034,1087,NA,175,17,NA,2209,1104,NA,2450
275,MT- GREAT FALLS,04-11-2020,735,388,NA,70,14,NA,805,402,NA,3675
276,MT- MISSOULA,04-11-2020,1054,548,NA,105,31,NA,1159,579,NA,12250
277,NE- LINCOLN,04-11-2020,1767,904,NA,70,14,NA,1837,918,NA,3675
278,NE- OMAHA,04-11-2020,5432,2723,NA,35,10,NA,5467,2733,NA,2450
279,NV- LAS VEGAS,04-11-2020,3907,2024,NA,175,17,NA,4082,2041,NA,2450
280,NV- RENO,04-11-2020,1571,890,NA,350,70,NA,1921,960,NA,4900
281,NH- LEBANON,04-11-2020,796,433,NA,175,52,NA,971,485,NA,3675
282,NH- MANCHESTER,04-11-2020,1694,931,NA,280,56,NA,1974,987,NA,7350
283,NJ- CAMDEN,04-11-2020,7742,3969,NA,245,24,NA,7987,3993,NA,4900
284,NJ- HACKENSACK,04-11-2020,3589,1850,NA,140,14,NA,3729,1864,NA,2450
285,NJ- MORRISTOWN,04-11-2020,1788,936,NA,140,28,NA,1928,964,NA,9800
288,NJ- NEW BRUNSWICK,04-11-2020,2521,1334,NA,245,49,NA,2766,1383,NA,7350
289,NJ- NEWARK,04-11-2020,4651,2409,NA,210,21,NA,4861,2430,NA,3675
291,NJ- PATERSON,04-11-2020,898,561,NA,280,28,NA,1178,589,NA,8575
292,NJ- RIDGEWOOD,04-11-2020,757,389,NA,35,7,NA,792,396,NA,11025
293,NM- ALBUQUERQUE,04-11-2020,3009,1574,NA,350,105,NA,3359,1679,NA,12250
295,NY- ALBANY,04-11-2020,4614,2433,NA,315,31,NA,4929,2464,NA,2450
296,NY- BINGHAMTON,04-11-2020,719,443,NA,210,21,NA,929,464,NA,11025
297,NY- BRONX,04-11-2020,3410,1789,NA,210,21,NA,3620,1810,NA,3675
299,NY- BUFFALO,04-11-2020,3245,1692,NA,350,105,NA,3595,1797,NA,4900
300,NY- ELMIRA,04-11-2020,832,465,NA,245,73,NA,1077,538,NA,12250
301,NY- EAST LONG ISLAND,04-11-2020,10869,5448,NA,70,21,NA,10939,5469,NA,1225
304,NY- ROCHESTER,04-11-2020,2715,1431,NA,245,49,NA,2960,1480,NA,7350
307,NY- SYRACUSE,04-11-2020,2615,1370,NA,210,42,NA,2825,1412,NA,8575
308,NY- WHITE PLAINS,04-11-2020,2829,1470,NA,140,14,NA,2969,1484,NA,1225
309,NC- ASHEVILLE,04-11-2020,1808,925,NA,70,14,NA,1878,939,NA,2450
311,NC- CHARLOTTE,04-11-2020,5547,2872,NA,245,24,NA,5792,2896,NA,12250
312,NC- DURHAM,04-11-2020,4477,2294,NA,140,14,NA,4617,2308,NA,2450
313,NC- GREENSBORO,04-11-2020,1654,855,NA,140,42,NA,1794,897,NA,8575
314,NC- GREENVILLE,04-11-2020,2404,1233,NA,105,21,NA,2509,1254,NA,1225
315,NC- HICKORY,04-11-2020,713,364,NA,35,10,NA,748,374,NA,7350
318,NC- RALEIGH,04-11-2020,4200,2110,NA,35,7,NA,4235,2117,NA,9800
319,NC- WILMINGTON,04-11-2020,1042,556,NA,175,52,NA,1217,608,NA,6125
320,NC- WINSTON-SALEM,04-11-2020,3367,1810,NA,315,31,NA,3682,1841,NA,2450
321,ND- BISMARCK,04-11-2020,628,356,NA,210,63,NA,838,419,NA,2450
322,ND- FARGO MOORHEAD -MN,04-11-2020,1749,986,NA,280,28,NA,2029,1014,NA,9800
323,ND- GRAND FORKS,04-11-2020,377,230,NA,210,63,NA,587,293,NA,9800
324,ND- MINOT,04-11-2020,525,333,NA,175,17,NA,700,350,NA,11025
325,OH- AKRON,04-11-2020,2286,1199,NA,140,14,NA,2426,1213,NA,9800
326,OH- CANTON,04-11-2020,1940,1022,NA,175,35,NA,2115,1057,NA,6125
327,OH- CINCINNATI,04-11-2020,4724,2376,NA,70,21,NA,4794,2397,NA,11025
328,OH- CLEVELAND,04-11-2020,8756,4392,NA,70,21,NA,8826,4413,NA,8575
329,OH- COLUMBUS,04-11-2020,8710,4428,NA,245,49,NA,8955,4477,NA,9800
330,OH- DAYTON,04-11-2020,3233,1627,NA,35,7,NA,3268,1634,NA,11025
331,OH- ELYRIA,04-11-2020,620,331,NA,105,31,NA,725,362,NA,6125
332,OH- KETTERING,04-11-2020,911,529,NA,245,49,NA,1156,578,NA,11025
334,OH- TOLEDO,04-11-2020,4014,2042,NA,175,52,NA,4189,2094,NA,4900
335,OH- YOUNGSTOWN,04-11-2020,2530,1279,NA,70,21,NA,2600,1300,NA,1225
336,OK- LAWTON,04-11-2020,363,321,NA,350,35,NA,713,356,NA,9800
339,OK- OKLAHOMA CITY,04-11-2020,6545,3280,NA,35,10,NA,6580,3290,NA,2450
340,OK- TULSA,04-11-2020,4987,2508,NA,35,3,NA,5022,2511,NA,6125
341,OR- BEND,04-11-2020,90,171,NA,315,31,NA,405,202,NA,8575
342,OR- EUGENE,04-11-2020,965,545,NA,210,42,NA,1175,587,NA,8575
343,OR- MEDFORD,04-11-2020,825,468,NA,140,14,NA,965,482,NA,3675
344,OR- PORTLAND,04-11-2020,5096,2590,NA,140,28,NA,5236,2618,NA,1225
345,OR- SALEM,04-11-2020,366,204,NA,70,14,NA,436,218,NA,6125
346,PA- ALLENTOWN,04-11-2020,2842,1515,NA,315,63,NA,3157,1578,NA,3675
347,PA- ALTOONA,04-11-2020,625,326,NA,70,21,NA,695,347,NA,6125
350,PA- DANVILLE,04-11-2020,1204,696,NA,315,63,NA,1519,759,NA,9800
351,PA- ERIE,04-11-2020,2191,1106,NA,35,7,NA,2226,1113,NA,9800
352,PA- HARRISBURG,04-11-2020,2186,1124,NA,105,21,NA,2291,1145,NA,9800
354,PA- JOHNSTOWN,04-11-2020,390,265,NA,350,105,NA,740,370,NA,11025
355,PA- LANCASTER,04-11-2020,911,539,NA,280,56,NA,1191,595,NA,12250
356,PA- PHILADELPHIA,04-11-2020,12139,6133,NA,315,94,NA,12454,6227,NA,2450
357,PA- PITTSBURGH,04-11-2020,11462,5794,NA,210,42,NA,11672,5836,NA,4900
358,PA- READING,04-11-2020,1109,681,NA,315,31,NA,1424,712,NA,2450
359,PA- SAYRE,04-11-2020,331,207,NA,140,28,NA,471,235,NA,7350
360,PA- SCRANTON,04-11-2020,847,434,NA,35,7,NA,882,441,NA,4900
362,PA- WILKES-BARRE,04-11-2020,410,278,NA,245,49,NA,655,327,NA,4900
363,PA- YORK,04-11-2020,796,412,NA,35,3,NA,831,415,NA,3675
364,RI- PROVIDENCE,04-11-2020,2922,1503,NA,210,63,NA,3132,1566,NA,7350
365,SC- CHARLESTON,04-11-2020,2942,1478,NA,35,10,NA,2977,1488,NA,3675
366,SC- COLUMBIA,04-11-2020,3643,1864,NA,105,10,NA,3748,1874,NA,6125
367,SC- FLORENCE,04-11-2020,991,600,NA,350,70,NA,1341,670,NA,11025
368,SC- GREENVILLE,04-11-2020,2322,1175,NA,70,21,NA,2392,1196,NA,3675
369,SC- SPARTANBURG,04-11-2020,921,488,NA,140,42,NA,1061,530,NA,3675
370,SD- RAPID CITY,04-11-2020,408,288,NA,280,56,NA,688,344,NA,6125
371,SD- SIOUX FALLS,04-11-2020,2599,1352,NA,175,35,NA,2774,1387,NA,7350
373,TN- CHATTANOOGA,04-11-2020,2171,1106,NA,70,14,NA,2241,1120,NA,7350
374,TN- JACKSON,04-11-2020,1140,633,NA,210,42,NA,1350,675,NA,6125
375,TN- JOHNSON CITY,04-11-2020,800,456,NA,140,14,NA,940,470,NA,12250
376,TN- KINGSPORT,04-11-2020,1916,979,NA,70,14,NA,1986,993,NA,11025
377,TN- KNOXVILLE,04-11-2020,4035,2045,NA,140,42,NA,4175,2087,NA,8575
379,TN- MEMPHIS,04-11-2020,6073,3086,NA,245,73,NA,6318,3159,NA,2450
380,TN- NASHVILLE,04-11-2020,8379,4242,NA,175,35,NA,8554,4277,NA,8575
382,TX- ABILENE,04-11-2020,1083,615,NA,245,49,NA,1328,664,NA,6125
383,TX- AMARILLO,04-11-2020,1222,723,NA,280,28,NA,1502,751,NA,2450
385,TX- AUSTIN,04-11-2020,3183,1686,NA,315,63,NA,3498,1749,NA,2450
386,TX- BEAUMONT,04-11-2020,1055,591,NA,315,94,NA,1370,685,NA,2450
388,TX- BRYAN,04-11-2020,297,212,NA,315,94,NA,612,306,NA,7350
390,TX- CORPUS CHRISTI,04-11-2020,1877,991,NA,175,35,NA,2052,1026,NA,3675
391,TX- DALLAS,04-11-2020,12070,6105,NA,175,17,NA,12245,6122,NA,8575
393,TX- EL PASO,04-11-2020,2430,1341,NA,315,31,NA,2745,1372,NA,11025
394,TX- FORT WORTH,04-11-2020,4727,2419,NA,280,84,NA,5007,2503,NA,2450
396,TX- HARLINGEN,04-11-2020,1208,688,NA,210,21,NA,1418,709,NA,4900
397,TX- HOUSTON,04-11-2020,16716,8498,NA,350,35,NA,17066,8533,NA,3675
399,TX- LONGVIEW,04-11-2020,511,308,NA,175,35,NA,686,343,NA,8575
400,TX- LUBBOCK,04-11-2020,2250,1181,NA,140,14,NA,2390,1195,NA,7350
402,TX- MCALLEN,04-11-2020,1446,751,NA,140,42,NA,1586,793,NA,8575
406,TX- ODESSA,04-11-2020,1082,604,NA,210,42,NA,1292,646,NA,6125
411,TX- SAN ANGELO,04-11-2020,442,270,NA,245,73,NA,687,343,NA,9800
412,TX- SAN ANTONIO,04-11-2020,7131,3587,NA,105,31,NA,7236,3618,NA,9800
413,TX- TEMPLE,04-11-2020,904,466,NA,35,3,NA,939,469,NA,7350
416,TX- TYLER,04-11-2020,1569,795,NA,35,7,NA,1604,802,NA,8575
417,TX- VICTORIA,04-11-2020,627,355,NA,140,28,NA,767,383,NA,4900
418,TX- WACO,04-11-2020,457,284,NA,140,14,NA,597,298,NA,1225
420,TX- WICHITA FALLS,04-11-2020,620,338,NA,70,7,NA,690,345,NA,3675
421,UT- OGDEN,04-11-2020,485,341,NA,245,24,NA,730,365,NA,4900
422,UT- PROVO,04-11-2020,587,357,NA,315,94,NA,902,451,NA,8575
423,UT- SALT LAKE CITY,04-11-2020,3775,1958,NA,175,17,NA,3950,1975,NA,9800
424,VT- BURLINGTON,04-11-2020,1304,708,NA,280,84,NA,1584,792,NA,8575
426,VA- ARLINGTON,04-11-2020,2788,1425,NA,105,21,NA,2893,1446,NA,7350
427,VA- CHARLOTTESVILLE,04-11-2020,1228,649,NA,175,52,NA,1403,701,NA,1225
428,VA- LYNCHBURG,04-11-2020,542,313,NA,210,63,NA,752,376,NA,7350
429,VA- NEWPORT NEWS,04-11-2020,894,520,NA,245,49,NA,1139,569,NA,6125
430,VA- NORFOLK,04-11-2020,2637,1332,NA,70,21,NA,2707,1353,NA,6125
431,VA- RICHMOND,04-11-2020,4525,2333,NA,175,17,NA,4700,2350,NA,8575
432,VA- ROANOKE,04-11-2020,2759,1394,NA,35,3,NA,2794,1397,NA,9800
435,VA- WINCHESTER,04-11-2020,863,452,NA,70,14,NA,933,466,NA,11025
437,WA- EVERETT,04-11-2020,576,337,NA,245,73,NA,821,410,NA,3675
438,WA- OLYMPIA,04-11-2020,605,323,NA,70,14,NA,675,337,NA,6125
439,WA- SEATTLE,04-11-2020,5198,2697,NA,245,24,NA,5443,2721,NA,12250
440,WA- SPOKANE,04-11-2020,3549,1837,NA,210,42,NA,3759,1879,NA,1225
441,WA- TACOMA,04-11-2020,1157,606,NA,70,7,NA,1227,613,NA,3675
442,WA- YAKIMA,04-11-2020,229,184,NA,350,105,NA,579,289,NA,1225
443,WV- CHARLESTON,04-11-2020,2355,1205,NA,70,7,NA,2425,1212,NA,4900
444,WV- HUNTINGTON,04-11-2020,1475,808,NA,175,17,NA,1650,825,NA,11025
445,WV- MORGANTOWN,04-11-2020,1658,871,NA,105,10,NA,1763,881,NA,2450
446,WI- APPLETON,04-11-2020,547,294,NA,70,14,NA,617,308,NA,6125
447,WI- GREEN BAY,04-11-2020,1251,695,NA,350,105,NA,1601,800,NA,4900
448,WI- LA CROSSE,04-11-2020,920,470,NA,35,7,NA,955,477,NA,9800
449,WI- MADISON,04-11-2020,2974,1497,NA,35,7,NA,3009,1504,NA,6125
450,WI- MARSHFIELD,04-11-2020,1003,572,NA,175,17,NA,1178,589,NA,9800
451,WI- MILWAUKEE,04-11-2020,8215,4122,NA,35,3,NA,8250,4125,NA,1225
303,NY- NEW YORK,04-11-2020,15406,7731,NA,140,42,NA,15546,7773,NA,12250
452,WI- NEENAH,04-11-2020,243,185,NA,315,94,NA,558,279,NA,8575
456,WI- WAUSAU,04-11-2020,250,251,NA,315,31,NA,565,282,NA,2450
457,WY- CASPER,04-11-2020,351,315,NA,350,35,NA,701,350,NA,9800
